11111111111
10001000001
11101011101
10101012101
10000010001
11111111111