111111111111
101000000021
101111011111
101000010001
101011111101
100000000001
111111111111