1111111
1010001
1010101
1010101
1000121
1111111